7 7
1000001
1111101
0000101
1110101
1011111
1010001
1111101