10
8
10111111
11101001
10000001
10011101
11110101
10011101
10000001
10111001
10101001
11111001