####################
## ## * * * * * ##
##   ## ####* ##
## ############* ##
## ####   ##* ##
##    ## ##* ##
## ####   ##* ##
## ############* ##
## ##   #### ##
## ## ## #### ##
##     #### ##
####################
