####################
## ##      ##
##   ## #### ##
## ############ ##
##* ####   ## ##
##*    ## ## ##
##* ####   ## ##
##* ############ ##
##* ##   #### ##
##* ## ## #### ##
##     #### ##
####################
